SO ./texture/redbrick.xpm
WE  ./texture/mossy.xpm
EA  ./texture/greystone.xpm
NO ./texture/wood.xpm
C 255,255,0
F  100,20,42


                                                                     1111111
                                                                     1000001
                                                     11111111111111111000001
111111                                               10000000000000000000001
110101                                               10011111111111100000001
100001111                                         11110010000000000000000001
10000000011111111                                 100000100000000000000000001
1100000000000000011111111111111111111111111111111100000011111111111100000000011
10000000000000100000000000000000N0000000000000000000000000000000000000000000001
1100000000000000000000000000000000000000000111111001111111111111111000000000101
1000000000000011111111111111111100111111111     1001              1000000000001
110000000000001                10001            1001              1000000001111
 10011001111111                 1001       111   1001             100000001
 10011111         11111111111111110011111110001111001             10000001
 1001            10000000000000000000000000000000011             1000000001
11001111111111111100011111111110000000011111111111               1000000001
100000000000000000001         100000001                           10000001
10000010000000000001          100000001                           10000001
1111111000111111111          1000000001                1111111111110000001
      10001                  1000000001               10011100000000000001111
      100011                  100000001               100000000000000000000001
  1111100011111             11100000001               100000000000000000000001
 100000000000001            10000000001               100001111000010000010001
1000000000000001            1000000000011111111111111 100001   100010000010001
10000000000000001        1111000000000000000000000001 101001   100010000010001
10000000000001111        10000000111110000000000000011110001   1111000001 111
10000000000001            1111001     1000000000000000000001       11111
10000000000001               1001     1000000000000000000001
10000001111111111111111      1101     1000000000000000000001
100000010000000000000001     1001     1000000000000000000001
100000010000000000000001111111001111110000000000000011110001
10000001000000000000000000000000000000000000000000001   1111
10000001000000000000000000000000000000000000000000001
10000000000000000000000000000000000000000000000011111
1111111111110000000000000011111111111111100000001
            11111111111111              100000001
                                        111111111
