SO ./texture/redbrick.xpm
WE  ./texture/mossy.xpm
EA  ./texture/greystone.xpm
NO ./texture/wood.xpm
F 200,200,200
C 255,100,100



11111111
10100001
10101001
10100101
1000W001
10000001
10000101
10000001
11111111