SO ./texture/tex3
WE  ./texture/tex1
EA  ./texture/tex2
NO ./texture/tex4
F 56,79,88
C 153,76,0



11111111
10100001
10101001
10100001
1000E001
10000001
10000101
10000001
11111111