SO ./texture/tex3
WE  ./texture/tex1
EA  ./texture/tex2
NO ./texture/tex4
F 56,79,88
C 153,76,0



11111111111111
1E000000000001
10001000000001
10001000100001
10000000010001
10000000000001
10000000000001
10000000000001
11111111111111