SO ./texture/redbrick.xpm
WE  ./texture/eagle.xpm
EA  ./texture/greystone.xpm
NO ./texture/eagle.xpm
F 200,200,200
C 255,100,100


11
101
11
11111111
10101E01
10100101
10000001
100001011111
1001110110001
1001110011111
10011101
10000001
10111111
101
 1