SO ./texture/redbrick.xpm
WE  ./texture/mossy.xpm
EA  ./texture/greystone.xpm
NO ./texture/eagle.xpm
F 200,200,200
C 255,100,100

       111
      1001
1111111101
101000011
10101001
10100101
1000S001
10000001
10000101
10000001
11111111