SO ./texture/redbrick.xpm
WE  ./texture/mossy.xpm
EA  ./texture/greystone.xpm
NO /Users/jereverd/CLionProjects/Cube3d/texture/eagle.xpm
F 000,000,200
C 255,100,100


11
101
11
11111111
10100001    1
10101001
10100101
10000001
1000S001           1
100001011111
1001110110001         1
1001110011111
10011101
10000001               1
11111111
101
 1           1
1                              1