SO ./texture/tex3
WE  ./texture/tex1
EA  ./texture/tex2
NO ./texture/tex4
C 255,255,0
F  100,20,42


       1111111111111111111111111111111111111
       10010000000000000000000000000000000001
111111110110000011100000000000011111111111111
10111100011101111111111111111111
11110111111111011100000010001
11110111111111011101010010001
11000000110101011100000010001
1000000000000001100000010001     1111111
10000000000000001101010010001   10000001
1000001110101111110111100N001   1111111
11110111 1110101 101111010001
11111111 1111111 111111111111